%%%%%%%
%. P .%   
% %%% %
% %.% %
%. G .%
%%%%%%%
