%%%%%%%%%%%
%..%....P.%
%G....% .o%
%%%%%%%%%%%
